NO textures/north.xpm
SO textures/south.xpm
WE textures/west.xpm
EA textures/east.xpm



C 255,0,0
F 0,255,0


111111111111
100000000001
100000000001
100000000001
100000000001
100000100001
100000000001
100000000001
100000000001
100000000001
100000000001
1N0000000001
111111111111


